5 5
3
2 0 3 0 0
0 0 0 0 0
0 3 0 0 0
0 0 0 0 0
3 0 1 0 3